31 28
1111111111111111111111111111
1000000000000000000000000001
1011010111110110111110101101
1011010000000110000000101101
1011010111110110111110101101
1000003000000000000000000001
1011110110111111110110111101
1011110110111111110110111101
1000000110000000000110000001
1011110000111111110000111101
1011110000111111110000111101
1011010110000000000110101101
1011000110111001110110001101
1011000110111001110110001101
1011010000000030000000101101
1010010110111001110110100101
1010110110111001110110110101
1000110110000000000110110031
1011110110111111110110111101
1011110110111111110110111101
1000003000000110000003000001
1011110111110110111110111101
1011110111110110111110111101
1000110000000003000000112001
1000110110111111110110110001
1000110110111111110110110001
1000000110000110000110000001
1011111001110110111001111101
1011111001110110111001111101
1000000000000000000000000001
1111111111111111111111111111
1 1