31 28
1111111111111111111111111111
1000000030000000000000000001
1011110111110110111110111101
1011110111110110111110111101
1011110111110110111110111101
1000000000000000000000000001
1011110110111111110110111101
1011110110111111110110111101
1000000110000110000110000001
1011110110000110111111111101
1311110110000110111111111101
1011000110000000000110001101
1011000110111301110110001101
1011000110111001110110001101
1011110000111001110000111101
1000110110111001110110110001
1000110110111001110110110001
1000110110000000000110110001
1011110110111111110110111101
1011110110111111110110111101
1011113000000110000000000001
1011110111110110111110111101
1011110111110110111110111101
1000110000000000000000110001
1000110110111111110110110001
1000110110111111110110110001
1000000110000112000110000001
1011111111110110111111111101
1011111111110110111111111101
1000000000000000000000000001
1111111111111111111111111111
1 1