31 28
1111111111111111111111111111
1000000000000110000000000001
1011110111010110101110111101
1011111111010000101111111101
1011110111010110101110111101
1000000003000110000000000001
1011110110111111110110111101
1311110110111111110110111101
1000000000000110000000000001
1011110110110110110110111101
1011110110110110110110111101
1000010000003000000000100001
1011000110111111110110001101
1011000110100000010110001101
1011110300101111010000111101
1010110110100000010110110101
1010000110111001110110000101
1000110110000000000110110001
1110110110111111110110110111
1110110110111111110110110111
1000000110000000000110003001
1011110111111111111110111101
1011110111111111111110111101
1010110000000000000003112101
1010110110111111110110110101
1000110110111111110110110001
1000000110000110000110000001
1011101111110110111111011101
1011101111110110111111011101
1000000000000000000000000001
1111111111111111111111111111
1 1