31 28
1111111111111111111111111111
1000000000000000000000000001
1010010111110110111110100101
1011110000000110000000111101
1010010111110110111110100101
1000000030000000000000000001
1010110110110110110110110101
1010110110110110110110110101
1000000111110110111110000001
1011010111110110111110101101
1011010000000110000000101101
1011010110000000030110101101
1000000110111111110110000001
1010110110100000010110110101
1010110003000000000000110101
1010110110100000010110110101
1000000110111111110110000001
1011010110000000000110101101
1011010110111111110110101101
1011010110111111110110101101
1000003000000110000003000001
1011110111110110111110111101
1011110111110110111110111101
1011110111110110111110111101
1000003000000000000000000001
1011110110111111110110111101
1011110110111111110110111101
1030000110000110000110000001
1111110111110110111110111111
1111110111110110111110111111
1111110110000000000110111111
1111110110111111110110111111
1111110110100000010110111111
1111110000100000010000111111
1111110110100000010110111111
1111110110111111110110111111
1111110110000000000110111111
1111110110111111110110111111
1111110110111111110110111111
1000000000000110000000000001
1011110111110110111110111101
1011110111110110111110111101
1000110000000000000000110001
1110110110111111110110110111
1110110110111111110110110111
1000000110000110000110000001
1011101110110110110111011101
1011101110110110110111011101
1000000000000000000000000001
1111111111111111111111111111
1 1