7 28
1111111111111111111111111111
1022222222222222220302222221
1212210111111111111112121121
1212213122222222222212122121
1211110122222222111112122121
1222222222222222222222122121
1111111111111111111111111111
1 1