31 28
1111111111111111111111111111
1022222222222222222222222221
1211212111112112111112121121
1211212222222112222222121121
1211212111112112111112121121
1222222222222222222222222221
1211112112111111112112111121
1211112112111111112112111121
1322222112222222222112222221
1211112222111111112222111121
1211112222111111112222111121
1211012112222222222112101121
1211222112111221112112221121
1211222112111221112112221121
1211212222222222222222121131
1212212112111221112112122121
1212112112111221112112112121
1222112113222222222112112221
1211112112111111112112111121
1211112112111111112112111121
1222222222222112222222222221
1211112111112112111112111121
1211112111112112111112111121
1222112222222222222222112221
1222112112111111112112112221
1222112112111111112112112221
1222222112222112222112222221
1211111221112112111221111121
1211111221112112111221111121
1222222222222222222222222221
1111111111111111111111111111
1 1