31 28
1111111111111111111111111111
1022222222222112222222222221
1211112112112112112112111121
1222222112112112112112222221
1211112112112112112112111121
1222222222222223222222222221
1211112112111111112112111121
1211112112111111112112111121
1222222112222112222112222221
1212112111112112111112112121
1212112111112112111112112121
1212112112222223222112112121
1212112112111221112112112121
1212112112100220012112112121
1212222222100220012222222121
1212112112100220012112112121
1212112112111221112112112121
1212112112222222222112112121
1212112112111111112112112121
1212112112111111112112112121
1222222222222112222222222221
1211112111112112111112111121
1211112111112112111112111121
1222112222222222222223112221
1212112112111111112112112121
1212112112111111112112112121
1222222112222112222112222221
1211111111112112111111111121
1211111111112112111111111121
1222222222222222222222222221
1111111111111111111111111111
1 1