31 28
1111111111111111111111111111
1022222222222222222222222221
1212212111112113111112122121
1211112222222112222222111121
1212212111112112111112122121
1222222222222222222222222221
1212112112112112112112112121
1212112112111112112112112121
1222222111112112111112222221
1211212111112112111112121121
1211212222222112222222121121
1211312112222222222112121121
1222222112111111112112222221
1212112112122222212112112121
1212112222222222222222112121
1212112112122222212112112121
1222222112111111112112222221
1211212112222222222112121121
1211212112111111112112121121
1211212112111111112112121121
1222222222222112222222222221
1211112111112112111112111121
1211112111112112111112111121
1222112222222222222223112221
1112112112112112112112112111
1112111112112112112111112111
1222222112222112222112222221
1211121112112112112111211121
1211121112112112112111211121
1222222222222222222222222221
1111111111111111111111111111
1 1