31 28
1111111111111111111111111111
1022222222222112222222222221
1211112111112112111112111121
1211112111112112111112111121
1211112111112112111112111121
1222222222222222222222222221
1211112112111111112112111121
1211112112111111112112111121
1222222112222112222112222221
1111112111112112111112111111
1111112111112112111112111111
1111112112222222222112111111
1111112112111221112112111111
1111112112100020012112111111
1111112222100220012222111111
1111112112130220012112111111
1111112112111221112112111111
1111112112222222222112111111
1111112112111111112112111111
1111112112111111112112111111
1222222222222112222222222221
1211112111112112111112111121
1211112111112112111112111121
1222112222000000022222112221
1112112112111111112112112111
1112112112111111112112112111
1222222112222112222112232221
1211111111112112111111111121
1211111111112112111111111121
1222222222222222222222222231
1111111111111111111111111111
1 1