31 28
1111111111111111111111111111
1000000000000110000000000001
1011110111011111101110111101
1000000111000000001110000001
1011110111011111101110111101
1001100000000110000000011001
1011110110111111110110111101
1011110110111111110110111101
1000000110000110000110000001
1011110110110110110110111101
1011110110110110110110111101
1000010000000000000000100001
1011000110111111110110001101
1011000110100000010110001101
1011110000001111000000111101
1011110110100000010110111101
1000000110111111110110000001
1000110110000000000110110001
1110110110111111110110110111
1110110110111111110110110111
1000000000000000000000000001
1011110111011111101110111101
1011110111011111101110111101
1010110000000000000000112101
1010110110111111110110110101
1000110110111111110110110001
1000000110000110000110000001
1011111110111111110111111101
1011111110111111110111111101
1000000000000000000000000001
1111111111111111111111111111
1 1