31 28
1111111111111111111111111111
1000000000000110000000000001
1011110110110110110110111101
1000000110110110110110000001
1011110110110110110110111101
1000000000000000000000000001
1011110110111111110110111101
1011110110111111110110111101
1000000110000110000110000001
1010110111110110111110110101
1010110111110110111110110101
1010110110000000000110110101
1010110110111001110110110101
1010110110100000010110110101
1010000000100000010000000101
1010110110100000010110110101
1010110110111001110110110101
1010110110000000000110110101
1010110110111111110110110101
1010110110111111110110110101
1000000000000110000000000001
1011110111110110111110111101
1011110111110110111110111101
1000110000000000000000112001
1010110110111111110110110101
1010110110111111110110110101
1000000110000110000110000001
1011111111110110111111111101
1011111111110110111111111101
1000000000000000000000000001
1111111111111111111111111111
1 1