31 28
1111111111111111111111111111
1022222222222112222222222221
1211112111212112121112111121
1211111111212222121111111121
1211112111212112121112111121
1222222222222112222222222221
1211112112111111112112111121
1211112112111111112112111121
1222222222222113002222222221
1211112112112110112112111121
1211112112112110112112111121
1222212222222222222222122221
1211222112111111112112221121
1211222112122222212112221121
1211112222121111212222111121
1212112112122222212112110121
1212222112111221112112200121
1222112112222222222112113001
1112110112111111112112110111
1112110112111111112112110111
1222003112222222222112222221
1211110111111111111112111121
1211110111111111111112111121
1212112222222222222222112121
1212112112111111112112112121
1222112112111111112112112221
1222222112222112222112222221
1211121111112112111111211121
1211121111112112111111211121
1222222222222222222222222221
1111111111111111111111111111
1 1