31 28
1111111111111111111111111111
1022222222222112222222222221
1211112112112112112112111121
1222222112112112112112222201
1211112112112112112112111101
1222222222222222222222220031
1211112112111111112112111101
1211112112111111112112111101
1222222112222112222112222221
1212112111112112111112112121
1012112111112112111112112121
1012112112222222222112112121
1312112112111221112112112121
1012112112122222212112112121
1012222222122222212222222121
1212112112122222212112112121
1212112112111021112112112121
1212112112220302222112112121
1212112112111111112112112121
1212112112111111112112112121
1222222222222112222222222221
1211112111112112111112111121
1211112111112112111110111121
1222112222222222222203112221
1212112112111111112110112121
1212112112111111112112112121
1222222112222112222112222221
1211111111112112111111111121
1211111111112112111111111121
1222222222222222222222222221
1111111111111111111111111111
1 1