31 28
1111111111111111111111111111
1022222222220222222222222221
1211212111110112111112121121
1211212222003112222222121121
1211212111110112111112121121
1222222222220222222222222221
1011112112111111112112111121
1011112112111111112112111121
1300222112222222222112222221
1011112222111111112222111121
1011112222111111112222111121
1211212112222222222112121121
1211222112111221112112221101
1211222112111221112112221101
1211212222222222222222121131
1212212112111221112112122101
1212112112111221112112112101
1222112112222222222112112221
1211112112111111112112111121
1211112112111111112112111121
1222222222222112222222222221
1211112111112112111112111121
1211112111112112111112111121
1222112222222222222222112221
1222112112111111112112112221
1222112112111111112112112221
1222222112222112222112222221
1211111221112112111221111121
1211111221112112111221111121
1222222222222222222222222221
1111111111111111111111111111
1 1