31 28
1111111111111111111111111111
1022222222222222222222222221
1211112111112112111112111121
1211112111112112111112111121
1211112111112112111110111121
1222222222222222222203022221
1211112112111111112110111121
1211112112111111112112111121
1222222112222112222112222221
1211112112222112111111111121
1211112112220112111111111121
1211222112220302222112221121
1211222112111021112112221121
1211222112111221112112221121
1211112222111221112222111121
1222112112111221112112112221
1222112112111221112112112221
1222112112222222222112112221
1211112112111111112112111121
1211112112111111112112111121
1211112222222112222222222221
1211112111110112111112111121
1211112111110112111112111121
1222112222003002222222112221
1222112112111111112112112221
1222112112111111112112112221
1222222112222112222112222221
1211111111112112111111111121
1211111111112112111111111121
1222222222222222222222222221
1111111111111111111111111111
1 1